|B |B |B |B |B |B |B |B |B |B |B |B |B |B |B |
|B |F |F |F |F |F |F |F |F |F |F |F |F |F |B |
|B |F |B |B |F |F |S |F |F |F |F |F |B |F |B |
|B |F |B |F |F |B |B |B |B |B |F |F |B |F |B |
|B |F |B |F |F |F |F |F |F |F |F |F |B |F |B |
|B |F |B |F |F |B |I |V |J |B |F |F |B |F |B |
|B |F |B |F |F |B |V |V |V |B |F |F |D |F |B |
|B |F |B |B |F |B |O |V |L |B |F |F |B |F |B |
|B |F |F |B |F |B |B |B |B |B |F |F |B |F |B |
|B |F |F |B |F |F |F |F |F |F |F |B |B |F |B |
|B |F |F |F |F |B |B |B |B |B |F |F |F |F |B |
|B |B |B |B |F |F |F |F |F |F |F |B |B |B |B |
|B |B |B |B |F |B |B |B |B |B |F |B |B |B |B |
|B |B |B |B |F |F |F |P |F |F |F |B |B |B |B |
|B |B |B |B |B |B |B |B |B |B |B |B |B |B |B |